bpm=150.00;startoffset=33.000;channels=4;approach=4;
notes1=
0000 0000 0000 0000 1000 0020 0000 0000 3000 0040 0000 0000 1000 0020 1234 1234
1111 1033 3333 0013 2222 2033 3333 2143 1111 1022 2222 1000 3333 3044 4444 1234
4444 4033 3333 0000 2222 2033 3333 2143 1111 1022 2222 1000 3334 4044 4444 1234
1111 1033 3333 0013 2222 2033 3333 2143 1111 1022 2222 1000 3333 3044 4444 1234
4444 4033 3333 0000 2222 2033 3333 2143 1111 1022 2222 1000 3334 4044 4444 1234
1000;
notes2=
0000 0000 0000 0000 0000 0000 0000 0000 0000 0000 0000 0000 0000 0000 0000 0000
2222 2044 4444 0000 4444 4011 1111 0000 4444 4033 3333 0000 1111 1022 2222 0000
1111 1022 2222 0024 4444 4011 1111 0000 3333 3044 4444 0000 1112 2033 3333 0000
2222 2044 4444 0000 4444 4011 1111 0000 4444 4033 3333 0000 1111 1022 2222 0000
1111 1022 2222 0024 4444 4011 1111 0000 3333 3044 4444 0000 1112 2033 3333 0000
3000;

